
F   0,0,0

  EA ../images/purplestone.xpm


SO ../images/greystone.xpm
WE ../images/mossy.xpm
NO ../images/colorstone.xpm

    C       203,230,238

 11111111111111111111111111111111111111111111
1000000000000000000000000000000000000000000001
1000000001111100000000000000000000000000000001
1000000000000100000000000000000000000000000001
1000000000000100000000000000000000000000000001
1000000000000111111110000000000000000000000001
1000000000000000000000000000000000000000000001
1000000000000000000000000000000000000000000001
1000000001111111000000001111100000000000000001
1000000000000000000000000000000001000000000001
1000000000010000000000000000000001000000000001
1000000000010000000000000000000001000000000001
1000000000010000000000000N00000001000000000001
1000000000010000000000000000000001000000000001
1000000000010000000000000000000001000000000001
1000000000000000000011111111000001000000000001
1000000000000000000000000000000000000000000001
1000000000000000000000000000000000000000000001
 11111111111111111111111111111111111111111111 
